############################
#             #            #
#             #            #
#             #$           #
#             #####        #
#               #          #
#               #          #
#         s     #          #
#               #          -
#               #          #
#             o #          #
#            # ##          #
#            #             #
#            #             #
############################
