############################
#             #            #
#             #            #
#             #$           #
#             #####        #
#                          #
#                          #
#         s                #
#                          -
#                          #
#             o            #
#                          #
#                          #
#                          #
############################
