**********
***    ***
**      **
*        *
**      **
***    ***
**********