#############
#############
####     ####
###       ###
##         ##
##         ##
##         ##
###       ###
####s   s####
#############
#############