##########
## s    ##
##      ##
#     ####
#       ##
###   S###
##########