####################
#                  #
#     ##########   #
#                  #
#   s  #           #
#      #    D      #
#      #           #
#      #           #
#      #           #
#      #           #
#      #           #
#      #           #
#      #           #
#      #           #
#                  #
#                  #
#                  #
#                  #
####################
####################
