### ##
#s   #
#    #
#   s#
######
