##########
#        #
#        #
#        #
#   ######
#        #
#        #
#        #
#        #
##########
