##########
#        #
#        #
#        #
#   ######
#        #
#  D     #
#        #
#        #
##########
