#############
#############
####     ####
###   C   ###
##    D    ##
##         ##
##s        ##
###       ###
####     ####
#############
#############
