###########
#         #
# ### ### #
# #     # #
# #  #  # #
# #  D  # #
# #  #  # #
# #     # #
# ### ### #
#         #
###########
